# lvlwidth 105
# lvlheight 23
# bgcolor 0 0 0
# edgelightcolor 255 128 128
# edgeshadowcolor 255 0 0
# fillcolor 0 0 0
# pelletcolor 255 255 255
# fruittype 4

# startleveldata
0 0 0 0 0 0 0 0 0 0 0 0 0 0 0 0 0 0 0 0 0 0 0 0 0 0 0 0 0 0 0 0 0 0 0 0 0 0 0 0 0 0 0 0 0 0 0 0 0 0 0 0 0 0 0 0 0 0 0 0 0 0 0 0 0 0 0 0 0 0 0 0 0 0 0 0 0 0 0 0 0 0 0 0 0 0 0 0 0 0 0 0 0 0 0 0 0 0 0 0 0 0 0 0 0 
120 0 120 0 120 0 120 0 107 100 100 100 108 0 0 0 107 100 100 100 108 0 120 0 120 0 120 0 120 0 0 0 0 0 0 0 0 0 0 0 0 0 0 0 0 0 0 0 0 0 0 0 0 0 0 0 0 0 0 0 0 0 0 0 0 0 0 0 0 0 0 0 0 0 0 0 0 0 0 0 0 0 0 0 0 0 0 0 0 0 0 0 0 0 0 0 0 0 0 0 0 0 0 0 0 
0 0 0 0 0 0 0 107 106 0 0 0 105 108 0 107 106 0 0 0 105 108 0 0 0 0 0 0 0 0 0 0 0 0 0 0 0 0 0 0 0 0 0 0 0 0 0 0 0 0 0 0 0 0 0 0 0 0 0 0 0 0 0 0 0 0 0 0 0 0 0 0 0 0 0 0 0 0 0 0 0 0 0 0 0 0 0 0 0 0 0 0 0 0 0 0 0 0 0 0 0 0 0 0 0 
3 0 3 0 3 0 107 106 0 0 113 0 0 105 133 106 0 0 113 0 0 105 108 0 3 0 3 0 3 0 0 0 0 0 0 0 0 0 0 0 0 0 0 0 0 0 0 0 0 0 0 0 0 0 0 0 0 0 0 0 0 0 0 0 0 0 0 0 0 0 0 0 0 0 0 0 0 0 0 0 0 0 0 0 0 0 0 0 0 0 0 0 0 0 0 0 0 0 0 0 0 0 0 0 0 
0 0 0 0 0 107 106 0 0 111 130 112 0 0 101 0 0 111 130 112 0 0 105 108 0 0 0 0 0 0 0 0 0 0 0 0 0 0 0 0 0 0 0 0 0 0 0 0 0 0 0 0 0 0 0 0 0 0 0 0 0 0 0 0 0 0 0 0 0 0 0 0 0 0 0 0 0 0 0 0 0 0 0 0 0 0 0 0 0 0 0 0 0 0 0 0 0 0 0 0 0 0 0 0 0 
120 0 120 0 0 101 0 0 0 0 0 0 0 111 130 112 0 0 0 0 0 0 0 101 0 0 120 0 120 0 0 113 0 113 0 113 0 120 0 113 0 113 0 0 0 0 0 0 0 0 0 0 0 0 0 0 0 0 0 0 0 0 0 0 0 0 0 0 0 0 0 113 0 0 0 113 0 0 0 0 0 0 0 0 0 0 0 0 0 0 0 0 0 0 0 107 100 108 0 0 0 0 0 0 0 
0 0 0 0 0 131 112 0 111 100 108 0 0 0 0 0 0 0 107 100 112 0 111 132 0 0 0 0 0 0 0 101 0 101 0 101 0 0 0 101 0 101 0 0 0 113 0 113 0 0 0 0 0 0 0 0 0 0 0 0 107 100 133 100 108 0 0 0 0 0 0 131 100 108 0 131 100 108 0 113 0 113 0 0 0 107 100 133 100 108 0 107 100 108 0 110 0 101 0 0 0 0 0 0 0 
3 0 3 0 0 101 0 0 0 0 101 0 107 112 1 111 108 0 101 0 0 0 0 101 0 0 3 0 3 0 0 101 0 101 0 101 0 113 0 101 0 101 0 0 0 101 0 101 0 107 100 108 0 113 0 113 0 0 0 0 101 0 101 0 101 0 107 100 108 0 0 101 0 110 0 101 0 110 0 101 0 101 0 0 0 101 0 101 0 101 0 101 12 101 0 0 107 106 0 0 0 0 0 0 0 
0 0 0 0 0 131 100 100 112 0 101 0 101 0 0 0 101 0 101 0 111 100 100 132 0 0 0 0 0 0 0 105 133 130 133 106 0 101 0 101 0 101 0 0 0 105 100 132 0 101 13 101 0 101 0 101 0 0 0 0 101 0 101 0 101 0 101 11 101 0 0 101 0 0 0 101 0 0 0 105 100 132 0 0 0 101 0 101 0 101 0 131 100 106 0 0 110 0 0 0 0 0 0 0 0 
120 0 120 0 0 101 0 0 0 0 101 0 105 100 133 100 106 0 101 0 0 0 0 101 0 0 120 0 120 0 0 0 110 0 110 0 0 110 0 110 0 110 0 0 0 0 0 101 0 105 100 106 0 105 100 130 112 0 0 0 110 0 110 0 110 0 105 100 130 112 0 110 0 0 0 110 0 0 0 0 0 101 0 0 0 110 0 110 0 110 0 101 0 0 0 0 0 0 0 0 0 0 0 0 0 
0 0 0 0 0 105 108 0 0 0 110 0 0 0 110 0 0 0 110 0 0 0 107 106 0 0 0 0 0 0 0 0 0 0 0 0 0 0 0 0 0 0 0 0 0 0 111 106 0 0 0 0 0 0 0 0 0 0 0 0 0 0 0 0 0 0 0 0 0 0 0 0 0 0 0 0 0 0 0 0 111 106 0 0 0 0 0 0 0 0 0 105 100 112 0 0 120 0 0 0 0 0 0 0 0 
3 0 3 0 3 0 105 108 0 0 0 0 113 0 10 0 113 0 0 0 0 107 106 0 3 0 3 0 3 0 0 0 0 0 0 0 0 0 0 0 0 0 0 0 0 0 0 0 0 0 0 0 0 0 0 0 0 0 0 0 0 0 0 0 0 0 0 0 0 0 0 0 0 0 0 0 0 0 0 0 0 0 0 0 0 0 0 0 0 0 0 0 0 0 0 0 0 0 0 0 0 0 0 0 0 
0 0 0 0 0 0 0 105 108 0 0 111 130 133 100 133 130 112 0 0 107 106 0 0 0 0 0 0 0 0 111 100 100 100 100 100 100 100 100 100 100 100 100 100 100 100 100 100 100 100 100 100 100 100 100 100 100 100 100 100 100 100 100 100 100 100 100 100 100 100 100 100 100 100 100 100 100 100 100 100 100 100 100 100 100 100 100 100 100 100 100 100 100 100 100 100 100 100 112 0 0 0 0 0 0 
120 0 120 0 120 0 0 0 105 108 0 0 0 110 0 110 0 0 0 107 106 0 0 0 120 0 120 0 120 0 0 0 0 0 0 0 0 0 0 0 0 0 0 0 0 0 0 0 0 0 0 0 0 0 0 0 0 0 0 0 0 0 0 0 0 0 0 0 0 0 0 0 0 0 0 0 0 0 0 0 0 0 0 0 0 0 0 0 0 0 0 0 0 0 0 0 0 0 0 0 0 0 0 0 0 
0 0 0 0 0 0 0 0 0 105 108 0 0 0 0 0 0 0 107 106 0 0 0 0 0 0 0 0 0 0 0 0 0 0 0 0 0 0 0 0 0 0 0 0 0 0 0 0 0 0 0 0 0 0 0 0 0 0 0 0 0 0 0 0 0 0 0 0 0 0 0 0 0 0 0 0 0 0 0 0 0 0 0 0 0 0 0 0 0 0 0 0 0 0 0 0 0 0 0 0 0 0 0 0 0 
3 0 3 0 3 0 3 0 3 0 105 108 0 0 0 0 0 107 106 0 3 0 3 0 3 0 3 0 3 0 0 0 0 0 0 0 0 0 0 0 0 0 0 0 0 0 0 0 0 0 0 0 0 0 0 0 0 0 0 0 0 0 0 0 0 0 0 0 0 0 0 0 0 0 0 0 0 0 0 0 0 0 0 0 0 0 0 0 0 0 0 0 0 0 0 0 0 0 0 0 0 0 0 0 0 
0 0 0 0 0 0 0 0 0 0 0 105 108 0 0 0 107 106 0 0 0 0 0 0 0 0 0 0 0 0 0 0 0 0 0 0 0 0 0 0 0 0 0 0 0 0 0 0 0 0 0 0 0 0 0 0 0 0 0 0 0 0 0 0 0 0 0 0 0 0 0 0 0 0 0 0 0 0 0 0 0 0 0 0 0 0 0 0 0 0 0 0 0 0 0 0 0 0 0 0 0 0 0 0 0 
120 0 120 0 120 0 120 0 120 0 120 0 105 108 0 107 106 0 120 0 120 0 120 0 120 0 120 0 120 0 0 0 0 0 0 0 0 0 0 0 0 0 0 0 0 0 0 0 0 0 0 0 0 0 0 0 0 0 0 0 0 0 0 0 0 0 0 0 0 0 0 0 0 0 0 0 0 0 0 0 0 0 0 0 0 0 0 0 0 0 0 0 0 0 0 0 0 0 0 0 0 0 0 0 0 
0 0 0 0 0 0 0 0 0 0 0 0 0 105 100 106 0 0 0 0 0 0 0 0 0 0 0 0 0 0 0 0 0 0 0 0 0 0 0 0 0 0 0 0 0 0 0 0 0 0 0 0 0 0 0 0 0 0 0 0 0 0 0 0 0 0 0 0 0 0 0 0 0 0 0 0 0 0 0 0 0 0 0 0 0 0 0 0 0 0 0 0 0 0 0 0 0 0 0 0 0 0 0 0 0 
3 0 3 0 3 0 3 0 3 0 3 0 3 0 0 0 3 0 3 0 3 0 3 0 3 0 3 0 3 0 0 0 0 0 0 0 0 0 0 0 0 0 0 0 0 0 0 0 0 0 0 0 0 0 0 0 0 0 0 0 0 0 0 0 0 0 0 0 0 0 0 0 0 0 0 0 0 0 0 0 0 0 0 0 0 0 0 0 0 0 0 0 0 0 0 0 0 0 0 0 0 0 0 0 0 
107 100 100 100 100 100 100 100 100 100 100 100 100 100 100 100 100 100 100 100 100 100 100 100 100 100 100 100 100 100 100 100 100 100 100 100 100 100 100 100 100 100 100 100 100 100 100 100 100 100 100 100 100 100 100 100 100 100 100 100 100 100 100 100 100 100 100 100 100 100 100 100 100 100 100 100 100 100 100 100 100 100 100 100 100 100 100 100 100 100 100 100 100 100 100 100 100 100 108 0 0 0 0 0 0 
101 4 2 2 2 2 2 2 2 2 2 2 2 2 2 2 2 2 2 2 2 2 2 2 2 2 2 2 2 2 2 2 2 2 2 2 2 2 2 2 2 2 2 2 2 2 2 2 2 2 2 2 2 2 2 2 2 2 2 2 2 2 2 2 2 2 2 2 2 2 2 2 2 2 2 2 2 2 2 2 2 2 2 2 2 2 2 2 2 2 2 2 2 2 2 2 2 2 101 0 0 0 0 0 0 
105 100 100 100 100 100 100 100 100 100 100 100 100 100 100 100 100 100 100 100 100 100 100 100 100 100 100 100 100 100 100 100 100 100 100 100 100 100 100 100 100 100 100 100 100 100 100 100 100 100 100 100 100 100 100 100 100 100 100 100 100 100 100 100 100 100 100 100 100 100 100 100 100 100 100 100 100 100 100 100 100 100 100 100 100 100 100 100 100 100 100 100 100 100 100 100 100 100 106 0 0 0 0 0 0 
# endleveldata

# sprites
