# lvlwidth 21
# lvlheight 27
# bgcolor 0 0 0
# edgelightcolor 52 61 139
# edgeshadowcolor 35 41 95
# fillcolor 0 0 0
# pelletcolor 238 183 128
# fruittype 3

# startleveldata
111 112 21 111 100 100 100 100 100 100 100 100 100 100 100 100 100 112 21 111 112 
20 0 2 2 2 2 2 2 2 2 2 2 2 2 2 2 2 2 2 0 20 
111 108 2 107 100 100 100 100 100 100 100 100 100 100 100 100 100 108 2 107 112 
0 101 2 101 22 0 0 0 0 0 0 0 0 0 0 0 0 101 2 101 0 
0 101 2 101 0 0 0 0 0 0 0 0 0 0 0 0 0 101 2 101 0 
111 106 2 101 0 0 0 0 0 0 0 0 0 0 0 0 0 101 2 105 112 
20 0 2 105 100 100 133 100 100 100 133 100 100 100 133 100 100 106 2 0 20 
111 108 2 2 2 2 110 2 2 2 110 2 2 2 110 2 2 2 2 107 112 
0 101 2 111 108 2 2 2 113 0 10 0 113 2 2 2 107 112 2 101 0 
0 101 2 2 110 0 120 0 131 112 1 111 132 0 120 0 110 2 2 101 0 
0 131 108 2 2 2 2 2 101 11 12 13 101 2 2 2 2 2 107 132 0 
111 130 106 2 111 100 112 2 105 100 100 100 106 2 111 100 112 2 105 130 112 
20 0 2 2 2 2 2 2 2 2 2 2 2 2 2 2 2 2 2 0 20 
111 108 2 113 2 120 2 113 2 120 0 120 2 113 2 120 2 113 2 107 112 
0 101 2 101 2 2 2 101 2 2 4 2 2 101 2 2 2 101 2 101 0 
0 101 2 110 2 111 100 130 100 112 0 111 100 130 100 112 2 110 2 101 0 
0 101 2 2 2 2 2 2 2 2 2 2 2 2 2 2 2 2 2 101 0 
111 106 2 120 3 120 2 120 2 113 2 113 2 120 2 120 3 120 2 105 112 
20 0 2 2 2 2 2 2 2 101 2 101 2 2 2 2 2 2 2 0 20 
111 108 2 111 100 112 2 111 100 106 2 105 100 112 2 111 100 112 2 107 112 
0 101 2 2 2 2 2 2 2 2 2 2 2 2 2 2 2 2 2 101 0 
0 105 100 100 100 100 100 100 100 100 100 100 100 100 100 100 100 100 100 106 0 
0 0 0 0 0 0 0 0 0 0 0 0 0 0 0 0 0 0 0 0 0 
0 0 0 107 100 100 100 100 100 100 133 100 100 100 100 100 100 108 0 0 0 
0 107 100 106 2 2 2 2 2 2 110 2 2 2 2 2 2 105 100 108 0 
0 101 2 2 2 107 100 100 108 2 2 2 107 100 100 108 2 2 2 101 0 
0 110 21 111 100 106 0 0 105 100 100 100 106 0 0 105 100 112 21 110 0 
# endleveldata

# sprites
